Transaction ID,Posting Date,Effective Date,Transaction Type,Amount,Check Number,Reference Number,Description,Transaction Category,Type,Balance,Memo,Extended Description
,9/28/2023,,Debit,-18.02,,,POS Card purchase WENDY'S 8028 5814 565 WALTON BLVD LAS CRUCES NM,,Debit Card,204.65,,POS Card purchase WENDY'S 8028 5814 565 WALTON BLVD LAS CRUCES NM
,9/28/2023,,Debit,-3.19,,,Debit Card purchase GOOGLE *SUPERCELL 5818 G.CO/HELPPAY# CA,,Debit Card,222.67,,Debit Card purchase GOOGLE *SUPERCELL 5818 G.CO/HELPPAY# CA
,9/28/2023,,Debit,-10.65,,,Debit Card purchase GOOGLE *SUPERCELL 5818 G.CO/HELPPAY# CA,,Debit Card,225.86,,Debit Card purchase GOOGLE *SUPERCELL 5818 G.CO/HELPPAY# CA
,9/28/2023,,Debit,-5.32,,,Debit Card purchase GOOGLE *SUPERCELL 5818 G.CO/HELPPAY# CA,,Debit Card,236.51,,Debit Card purchase GOOGLE *SUPERCELL 5818 G.CO/HELPPAY# CA
,9/28/2023,,Debit,-19.35,,,Debit Card purchase MCDONALD'S F20533 5814 LAS CRUCES NM,,Debit Card,241.83,,Debit Card purchase MCDONALD'S F20533 5814 LAS CRUCES NM
,9/27/2023,,Debit,-18.89,,,Raising Cane's,Restaurants & Dining,Debit Card,261.18,,Debit Card purchase RAISING CANES 0340 5814 LAS CRUCES NM
,9/27/2023,,Debit,-5.63,,,Einstein Bros. Bagels,Restaurants & Dining,Debit Card,280.07,,Debit Card purchase EINSTEINS CCSU 5814 LAS CRUCES NM
,9/25/2023,,Debit,-20.13,,,Whataburger,Restaurants & Dining,Debit Card,285.7,,Debit Card purchase WHATABURGER 465 5814 LAS CRUCES NM
,9/25/2023,,Debit,-12.82,,,ACH Withdrawal COMPANY: CRUNCH FIT ENTRY: CLUB FEES XX-8030 ISAIAH MALCON,Personal Care & Fitness,,305.83,,ACH Withdrawal COMPANY: CRUNCH FIT ENTRY: CLUB FEES 505-387-8030 ISAIAH MALCON
